qeynos=Southern Newport
qeynos2=Northern Newport
qrg=Surefall Glade
qeytoqrg=Centaur Hills
highpass=King's Pass
highkeep=HighKeep
freportn=North Freeport
freportw=West Freeport
freporte=East Freeport
runnyeye=The Runnyeye Citadel
qey2hh1=Western Badlands
northkarana=Northern Badlands
southkarana=Southern Badlands
eastkarana=Eastern Badlands
beholder=Gorge of the One-Eye
blackburrow=BlackBurrow
paw=Lair of Paw
rivervale=Rivervale
kithicor=Shadowdale
commons=Western Plaguelands
ecommons=Eastern Plaguelands
erudnint=Erudin Palace
erudnext=Erudin
nektulos=The Darkwoods
cshome=Sunset Home
lavastorm=Red Sun Peaks
nektropos=Shadorest
halas=Halas
everfrost=Everfrost Peaks
soldunga=Red Sun Mines
soldungb=Fire Grottos
misty=Whisperling Forest
nro=Northern Waste of Tarhyl
sro=Southern Waste of Tarhyl
befallen=Halls of Misery
oasis=The Oasis
tox=Mistwoods
hole=Ruins of First City
neriaka=Ruins of Old Nagthilan
neriakb=Ruins of Old Nagthilan
neriakc=Ruins of Old Nagthilan
neriakd=Haegra Malath
najena=Tunnels of Lasanth
qcat=Newport Sewers
innothule=Stinger's Bog
feerrott=Greenmist Jungle
cazicthule=Hidden Temple of Yaralith
oggok=Oggok
rathemtn=Obsidian Shard Mountains
lakerathe=Lake Starfall
grobb=Grobb
night=The Nightmare
gfaydark=Greater Faydark
akanon=Underhill
steamfont=Steamfont Mountains
lfaydark=Lesser Faydark
crushbone=Fearstone Keep
mistmoore=Eldenal's Mansion
kaladima=Kaladim
felwithea=Athica
felwitheb=Athica
unrest=Shrouded Island
kedge=Kedge Keep
guktop=Halls of Mielech
gukbottom=Keep of Mielech
kaladimb=Kaladim
butcher=Goblin Skull Mountains
oot=Sea of Swords
cauldron=Cauldron of Dawn
airplane=Plane of Sky
fearplane=Plane of Fear
permafrost=Everchill Caverns
kerraridge=Sadri Malath
paineel=Valley of Erimal
hateplane=Lilla's Manor
arena=The Arena
fieldofbone=The Field of Bone
warslikswood=Forest of the Fallen
soltemple=Temple of Elael
droga=The Bloodied Quarry
cabwest=West New Ikild
swampofnohope=The Murk
firiona=Prophet's Landing
lakeofillomen=Lake of Ill Omen
dreadlands=Dreadlands
burningwood=Tears of Elael
kaesora=Kaesora
sebilis=Lair of Mielech
citymist=The Veiled City
skyfire=Skyfire Mountains
frontiermtns=Frontier Mountains
overthere=The Overthere
emeraldjungle=The Emerald Jungle
trakanon=Remnants of Old Ikild
timorous=Timorous Deep
kurn=Spires of Saitha
erudsxing=Storm Sea
stonebrunt=Sundered Mountains
warrens=The Warrens
karnor=Citadel of the Claw
chardok=Tur`Ruj
dalnir=The Silent Halls
charasis=Odeum of Profundity
cabeast=West New Ikild
nurga=Oggok Mines
veeshan=Burning Eye
veksar=Heartland Undercaverns
iceclad=Frosthorn Coast
frozenshadow=Dreadfang Spire
velketor=Sorcerer's Labyrinth
kael=Stormkeep
skyshrine=Prison of Admyrrza
thurgadina=City of Thurgadin
eastwastes=Eastern Wastes
cobaltscar=Wyvernfang Coast
greatdivide=Great Divide
wakening=Faentharc Woods
westwastes=Western Wastes
crystal=Crystal Caverns
necropolis=Dragon Necropolis
templeveeshan=Dragonhorn Keep
sirens=Siren's Grotto
mischiefplane=Plane of Mischief
growthplane=Plane of Earth
sleeper=Storm's Eye
thurgadinb=Icewell Keep
erudsxing2=Marauder's Mire
shadowhaven=Haven of Lore
bazaar=The Bazaar
nexus=Refresh Zone
echo=Echo Caverns
acrylia=Warpstone Caverns
sharvahl=Shar Vahl
paludal=The Abyss
fungusgrove=The Overgrowth
vexthal=Mansion of Portals
sseru=City of Mercy
katta=Taldor Malath
netherbian=Passage of Neth
ssratemple=Cyrtho Malath
griegsend=Grieg's End
thedeep=The Deepshade
shadeweaver=Shadeweaver's Thicket
hollowshade=Hollowshade Moor
grimling=Haegra Malath
mseru=The Barrens
letalis=The Troll Zone
twilight=The Twilight Sea
thegrey=The Blight
tenebrous=The Tenebrous Mountains
maiden=Spirit Valley
dawnshroud=Greenlight Hills
scarlet=The Scarlet Desert
umbral=The Silent Lands
akheva=Akhevan Ruins
arena2=The Arena
jaggedpine=Heartland Plateau
nedaria=Nedaria's Landing
tutorial=Pocket Plane
load=The Eternal Well
load2=The Eternal Well
hateplaneb=Lilla's Manor
codecay=Ruins of Lxanvom
pojustice=Jail
poknowledge=The House
potranquility=Plane of Tranquility
ponightmare=Plane of Nightmare
podisease=Plane of Entropy
poinnovation=The Rust
potorment=Towers of Agony
povalor=Plane of Valor
bothunder=Thazeran's Tower
postorms=Plane of Storms
hohonora=Plane of Valor
solrotower=Tower of Tarhyl
powar=Plane of War
potactics=Drunder, Fortress of Zek
poair=Tasinath, Land of Bliss
powater=Caverns of the Deep One
pofire=Azzerach, the Forsaken Realm
poeartha=Vegarlson, The Earthen Badlands
potimea=Plane of Time
hohonorb=Stronghold of Enthann
nightmareb=The Dream
poearthb=Ragrax, Stronghold of the Twelve
potimeb=Plane of Time
gunthak=Gunthak
dulak=Dulak
torgiran=Torgiran
nadox=Nadox
hatesfury=Hatesfury
guka=Mielech's Labratory
ruja=The Bloodied Quarries
taka=The Sunken Library
mira=The Silent Gallery
mmca=The Forlorn Caverns
gukb=The Drowning Crypt
rujb=The Halls of War
takb=The Shifting Tower
mirb=The Maw of the Menagerie
mmcb=The Dreary Grotto
gukc=The Ancient Aqueducts
rujc=The Wind Bridges
takc=The Fading Temple
mirc=The Spider Den
mmcc=Caverns of Darkness
gukd=The Mushroom Grove
rujd=The Gladiator Pits
takd=The Royal Observatory
mird=The Hushed Banquet
mmcd=The Chambers of Eternal Affliction
guke=Hollows of Underhill
ruje=The Drudge Hollows
take=The River of Recollection
mire=Azmaen, The Heart of Frost
mmce=Sepulcher of Darkness
gukf=The Chapel of the Witnesses
rujf=The Fortified Lair of the Taskmasters
takf=The Sandfall Corridors
mirf=The Forgotten Wastes
mmcf=Catacombs of Elthannar
gukg=Grobb Undercity
rujg=The Hidden Vale
takg=The Balancing Chamber
mirg=The Heart of the Menagerie
mmcg=The Cesspits
gukh=The Accursed Sanctuary
rujh=The Blazing Forge
takh=The Ethereal Dojo
mirh=The Morbid Laboratory
mmch=The Aisles of Blood
ruji=The Arena of Chance
taki=The Antiquated Palace
miri=The Theater of Imprisoned Horrors
mmci=The Halls of Sanguinary Rites
rujj=The Barracks of War
takj=The Prismatic Corridors
mirj=The Grand Library
mmcj=The Infernal Sanctuary
chardokb=The Halls of Betrayal
soldungc=Emberflow Caverns
abysmal=Abysmal Sea
natimbi=Natimbi, The Broken Shores
qinimi=Qinimi, Court of Nihilia
riwwi=Riwwi, Coliseum of Games
barindu=Barindu, Hanging Gardens
ferubi=Ferubi, Forgotten Temple of Talosia
snpool=Sewers of Nihilia, Pool of Sludge
snlair=Sewers of Nihilia, Lair of Trapped Ones
snplant=Sewers of Nihilia, Purifying Plant
sncrematory=Sewers of Nihilia, the Crematory
tipt=Tipt, Treacherous Crags
vxed=Vxed, The Crumbling Caverns
yxtta=Yxtta, Pulpit of Exiles
uqua=Uqua, The Ocean God Chantry
kodtaz=Kod'Taz, Sullied Ritual Hall
ikkinz=Your spell does critical damage!
qvic=You successfully set a trap for your enemies.
inktuta=Your spell performs an exceptional healing!
txevu=The trap that you set has expired.
tacvi=The trap that you set has been disarmed.
